50, 50
946
4
5000
eeeeeeeeeeeeeeeeeeeeeeeeeeeeeeeeeeeeeeeeeeeeeeeeee
..................................................
..................................................
e.ee.ee.ee..............................ee.ee.ee.e
e.ee.ee.ee..eeeeeeeeeee....eeeeeeeeeee..ee.ee.ee.e
e.ee.ee.ee..eeeeeeeeeee....eeeeeeeeeee..ee.ee.ee.e
e.ee.ee.ee..............................ee.ee.ee.e
............eeeeeeeeeee....eeeeeeeeeee............
e.ee.ee.ee..eeeeeeeeeee....eeeeeeeeeee..ee.ee.ee.e
e.ee.ee.ee..............................ee.ee.ee.e
e.ee.ee.ee..eeeeeeeeeee....eeeeeeeeeee..ee.ee.ee.e
e.ee.ee.ee..eeeeeeeeeee....eeeeeeeeeee..ee.ee.ee.e
e.ee.ee.ee..............................ee.ee.ee.e
e.ee.ee.ee..............................ee.ee.ee.e
e.ee.ee.ee..eeeeeee..eeeeeeee..eeeeeee..ee.ee.ee.e
e.ee.ee.ee..eeeeeee..eeeeeeee..eeeeeee..ee.ee.ee.e
..................................................
e.ee.ee.ee..............................ee.ee.ee.e
e.ee.ee.ee..eeeeeee..eeeeeeee..eeeeeee..ee.ee.ee.e
e.ee.ee.ee..eeeeeee..eeeeeeee..eeeeeee..ee.ee.ee.e
e.ee.ee.ee..............................ee.ee.ee.e
e.ee.ee.ee..............................ee.ee.ee.e
e.ee.ee.ee..eeeeeee..eeeeeeee..eeeeeee..ee.ee.ee.e
e.ee.ee.ee..eeeeeee..eeeeeeee..eeeeeee..ee.ee.ee.e
e.ee.ee.ee..............................ee.ee.ee.e
..................................................
..................................................
e..ee..ee..ee..ee..ee........ee..ee..ee..ee..ee..e
e..ee..ee..ee..ee..ee........ee..ee..ee..ee..ee..e
e..ee..ee..ee..ee..ee........ee..ee..ee..ee..ee..e
e..ee..ee..ee..ee..ee........ee..ee..ee..ee..ee..e
e..ee..ee..ee..ee..ee........ee..ee..ee..ee..ee..e
e..ee..ee..ee..ee..ee........ee..ee..ee..ee..ee..e
e..ee..ee..ee..ee..ee........ee..ee..ee..ee..ee..e
e..ee..ee..ee..ee..ee........ee..ee..ee..ee..ee..e
..................................................
..................................................
e..ee..ee..ee..ee..ee........ee..ee..ee..ee..ee..e
e..ee..ee..ee..ee..ee........ee..ee..ee..ee..ee..e
e..ee..ee..ee..ee..ee........ee..ee..ee..ee..ee..e
e..ee..ee..ee..ee..ee........ee..ee..ee..ee..ee..e
e..ee..ee..ee..ee..ee........ee..ee..ee..ee..ee..e
e..ee..ee..ee..ee..ee........ee..ee..ee..ee..ee..e
e..ee..ee..ee..ee..ee........ee..ee..ee..ee..ee..e
e..ee..ee..ee..ee..ee........ee..ee..ee..ee..ee..e
..................................................
..................................................
..................................................
...............rrrr...............................
..................................................